4	4	5	6	7	8	10	11	12	12	13	13	12	12	11	10	9	9	8	7	7	7	7	6	5	4	3	2	2	1	1	1	2	2	3	3	4	4	5	5	

4	4	5	6	7	8	9	10	12	12	13	12	12	12	11	10	9	9	8	7	7	7	7	6	5	4	3	2	2	1	1	1	2	2	3	3	4	4	4	5	

4	4	4	5	6	7	9	10	11	12	12	12	11	11	10	10	9	8	8	7	7	7	6	6	5	4	3	2	2	1	1	1	1	2	3	3	4	4	4	4	

3	3	4	5	6	7	8	9	10	11	11	11	11	10	10	9	9	8	7	7	7	7	6	5	5	4	3	2	2	1	1	1	2	2	3	3	3	4	4	4	

3	3	3	4	5	6	7	8	9	10	10	10	10	9	9	9	8	8	7	7	7	6	6	5	5	4	3	2	1	1	1	1	2	2	3	3	3	4	4	3	

2	2	3	3	4	5	6	7	8	9	9	9	9	9	9	8	8	7	7	7	6	6	6	5	4	3	2	2	1	1	1	1	2	2	3	3	3	3	3	3	

1	1	2	3	4	5	6	7	8	8	9	8	8	8	8	8	8	7	7	7	6	6	6	5	4	3	2	2	1	1	1	1	1	2	2	3	3	3	3	3	

1	1	1	2	3	4	6	7	8	8	8	8	8	8	8	8	7	7	7	7	7	6	6	5	4	3	2	2	1	1	1	1	1	1	2	2	3	3	3	2	

1	1	1	2	2	4	5	6	7	8	8	8	8	8	8	8	8	7	7	7	7	7	6	5	4	3	2	1	1	1	1	1	1	1	2	2	2	2	2	2	

1	1	1	1	2	3	5	6	7	8	8	8	8	8	8	8	8	7	7	7	7	7	6	5	4	3	2	1	1	1	1	1	1	1	2	2	2	2	2	2	

1	1	1	1	2	3	4	6	7	8	8	8	8	8	8	8	8	7	7	7	7	7	6	5	4	3	2	1	1	1	1	1	1	1	2	2	2	2	2	2	

1	1	1	1	2	3	4	6	7	8	8	8	8	8	8	8	8	7	7	7	7	7	6	5	4	3	2	1	1	1	1	1	1	1	1	2	2	2	2	2	

1	1	1	1	2	3	4	6	7	8	8	8	8	8	8	8	7	7	7	7	7	7	6	5	3	2	1	1	1	1	1	1	1	1	1	1	1	2	2	2	

1	1	1	1	2	3	4	6	7	8	8	8	8	8	8	8	7	7	7	6	7	6	5	4	3	2	1	1	1	1	1	1	1	1	1	1	1	1	1	2	

1	1	1	1	1	3	4	5	7	7	8	8	8	8	8	7	7	6	6	6	6	6	5	4	2	1	1	1	1	1	1	1	1	1	1	1	1	1	1	2	

1	1	1	1	1	2	3	5	6	6	7	7	7	7	7	6	6	5	5	5	5	5	4	3	2	1	1	1	1	1	1	1	1	1	1	1	1	1	1	1	

1	1	1	1	1	1	3	4	5	6	6	6	6	6	6	6	5	5	4	4	4	4	3	2	1	1	1	1	1	1	1	1	1	1	1	1	1	1	1	1	

1	1	1	1	1	1	2	3	4	5	6	6	6	5	5	5	4	4	3	3	3	3	2	1	1	1	1	1	1	1	1	1	1	1	1	1	1	1	1	1	

1	1	1	1	1	1	2	3	4	5	5	5	5	5	5	4	4	3	3	2	2	2	1	1	1	1	1	1	1	1	1	1	1	1	1	1	1	1	1	1	

1	1	1	1	1	1	2	3	4	5	6	6	5	5	5	4	4	3	3	2	2	2	1	1	1	1	1	1	1	1	1	1	1	1	1	1	1	1	1	1	

1	1	1	1	1	1	2	3	4	5	6	6	6	5	5	4	4	3	2	2	2	1	1	1	1	1	1	1	1	1	1	1	1	1	1	1	1	1	1	1	

1	1	1	1	1	1	2	3	4	5	6	6	5	5	5	4	4	3	2	2	1	1	1	1	1	1	1	1	1	1	1	1	1	1	1	1	1	1	1	1	

1	1	1	1	1	1	2	3	4	5	5	5	5	5	4	4	3	3	2	1	1	1	1	1	1	1	1	1	1	1	1	1	1	1	1	1	1	1	1	1	

1	1	1	1	1	1	2	3	4	4	5	5	4	4	4	3	3	2	2	1	1	1	1	1	1	1	1	1	1	1	1	1	1	1	1	1	1	1	1	1	

1	1	1	1	1	1	1	2	3	4	4	4	4	3	3	2	2	1	1	1	1	1	1	1	1	1	1	1	1	1	1	1	1	1	1	1	1	1	1	1	

1	1	1	1	1	1	1	2	3	3	3	3	3	2	2	2	1	1	1	1	1	1	1	1	1	1	1	1	1	1	1	1	1	1	1	1	1	1	1	1	

1	1	1	1	1	1	1	1	2	3	3	2	2	2	1	1	1	1	1	1	1	1	1	1	1	1	1	1	1	1	1	1	1	1	1	1	1	1	1	1	

1	1	1	1	1	1	1	1	2	2	2	2	1	1	1	1	1	1	1	1	1	1	1	1	1	1	1	1	1	1	1	1	1	1	1	1	1	1	1	1	

1	1	1	1	1	1	1	1	1	1	1	1	1	1	1	1	1	1	1	1	1	1	1	1	1	1	1	1	1	1	1	1	1	1	1	1	1	1	1	1	

1	1	1	1	1	1	1	1	1	1	1	1	1	1	1	1	1	1	1	1	1	1	1	1	1	1	1	1	1	1	1	1	1	1	1	1	1	1	1	1	

1	1	1	1	1	1	1	1	1	1	1	1	1	1	1	1	1	1	1	1	1	1	1	1	1	1	1	1	1	1	1	1	1	1	1	1	1	1	1	1	

1	1	1	1	1	1	1	1	1	1	1	1	1	1	1	1	1	1	1	1	1	1	1	1	1	1	1	1	1	1	1	1	1	1	1	1	1	1	1	1	

1	1	1	1	1	1	1	1	1	1	1	1	1	1	1	1	1	1	1	1	1	1	1	1	1	1	1	1	1	1	1	1	1	1	1	1	1	1	1	1	

1	1	1	1	1	1	1	1	1	1	1	1	1	1	1	1	1	1	1	1	1	1	1	1	1	1	1	1	1	1	1	1	1	1	1	1	1	1	1	1	

1	1	1	1	1	1	1	1	1	1	1	1	1	1	1	1	1	1	1	1	1	1	1	1	1	1	1	1	1	1	1	1	1	1	1	1	1	1	1	1	

1	1	1	1	1	1	1	1	1	1	1	1	1	1	1	1	1	1	1	1	1	1	1	1	1	1	1	1	1	1	1	1	1	1	1	1	1	1	1	1	

1	1	1	1	1	1	1	1	1	1	1	1	1	1	1	1	1	1	1	1	1	1	1	1	1	1	1	1	1	1	1	1	1	1	1	1	1	2	2	2	

1	1	1	1	1	1	1	1	1	1	1	1	1	1	1	1	1	1	1	1	1	1	1	1	1	1	1	1	1	1	1	1	1	1	1	2	2	3	3	3	

1	1	1	1	1	1	1	1	1	1	1	1	1	1	1	1	1	1	1	1	1	1	1	1	1	1	1	1	1	1	1	1	1	1	2	2	3	3	3	4	

1	1	1	1	1	1	1	1	1	1	1	1	1	1	1	1	1	1	1	1	1	1	1	1	1	1	1	1	1	1	1	1	1	1	2	3	3	4	4	4	

