5	5	6	8	9	10	11	12	14	14	14	15	15	15	15	15	15	14	15	15	14	14	13	12	10	9	7	5	4	3	2	2	2	2	1	1	1	1	1	1	1	1	1	1	1	1	2	2	3	3	

5	5	6	7	9	10	11	12	13	14	14	14	15	15	15	15	15	14	14	14	14	14	13	12	10	9	7	5	4	3	2	2	2	2	1	1	1	1	1	1	1	1	1	1	1	1	2	3	3	4	

5	6	6	7	9	10	11	12	13	14	14	14	14	15	15	15	14	14	14	14	14	14	13	12	10	9	7	5	4	3	2	2	2	2	1	1	1	1	1	1	1	1	1	1	1	2	3	3	4	4	

5	6	6	7	8	9	10	11	12	13	13	13	14	14	14	14	14	13	13	13	13	13	13	11	10	8	7	5	4	3	3	3	3	2	2	2	2	1	1	1	1	1	1	2	2	3	4	4	4	4	

5	5	6	7	8	9	10	11	11	12	12	12	13	13	13	13	13	12	12	13	13	12	12	11	9	8	7	6	4	4	3	4	3	3	3	3	2	2	2	2	2	2	3	3	4	4	4	5	5	5	

5	5	5	6	7	8	9	9	10	10	11	11	11	11	12	12	11	11	11	12	12	12	11	10	9	8	7	6	5	4	4	4	4	4	4	3	3	3	3	3	3	3	3	4	4	5	5	5	5	5	

4	4	5	5	6	7	7	8	8	9	9	9	10	10	10	10	10	10	11	11	11	11	10	10	9	8	7	7	6	5	5	5	5	5	5	4	4	4	4	3	3	3	4	4	4	5	5	5	5	5	

4	4	4	5	5	5	6	7	7	7	7	8	8	9	9	9	9	10	10	10	10	10	10	9	9	8	8	8	7	7	6	6	6	6	5	5	5	4	4	4	4	4	4	4	5	5	5	5	5	5	

4	4	4	4	5	5	5	6	6	6	6	6	7	7	8	8	9	9	9	9	9	9	9	9	9	9	9	8	8	8	7	7	7	7	6	6	6	5	5	4	4	4	4	4	5	5	5	5	5	5	

5	4	4	4	4	4	4	5	5	5	5	6	6	7	7	8	8	8	9	9	9	9	9	9	9	9	9	9	9	8	8	8	8	7	7	6	6	5	5	4	4	4	4	4	4	4	4	5	5	5	

5	5	4	4	4	4	4	4	4	5	5	5	6	6	7	7	8	8	8	9	9	9	9	9	9	9	9	9	9	9	8	8	8	7	7	6	6	5	5	4	4	4	4	4	4	4	4	4	5	5	

5	4	4	4	4	4	4	4	4	4	5	5	5	6	7	7	7	8	8	8	8	8	8	9	9	9	9	9	9	8	8	8	8	7	7	6	6	5	5	4	4	4	4	4	4	4	4	4	5	5	

4	4	4	3	3	3	3	3	3	3	4	4	4	5	6	6	6	7	7	8	8	8	8	8	8	8	8	8	8	8	8	8	8	7	7	6	6	5	5	4	4	3	3	3	3	3	4	4	4	5	

3	3	3	2	2	1	1	1	2	2	2	2	3	4	4	5	5	6	6	7	7	7	7	7	7	7	8	8	8	8	8	8	7	7	6	6	6	5	4	4	3	3	3	3	3	3	3	3	4	4	

3	2	2	1	1	1	1	1	1	1	1	1	1	2	3	3	4	4	5	6	6	6	6	6	6	7	7	7	8	8	8	8	7	7	6	6	6	5	4	3	3	3	3	3	3	3	3	3	4	4	

2	2	1	1	1	1	1	1	1	1	1	1	1	1	2	2	3	3	4	4	5	5	5	5	5	6	6	7	7	8	8	8	7	7	6	6	6	5	4	3	3	3	3	3	3	3	3	3	3	4	

2	1	1	1	1	1	1	1	1	1	1	1	1	1	1	1	1	2	3	3	3	3	4	4	5	5	6	7	7	8	8	8	7	7	6	6	6	5	4	3	3	3	3	3	3	3	3	3	3	4	

1	1	1	1	1	1	1	1	1	1	1	1	1	1	1	1	1	1	1	2	2	2	2	3	4	4	5	6	7	7	8	8	7	7	6	6	5	5	4	4	4	3	3	3	3	3	3	3	3	4	

1	1	1	1	1	1	1	1	1	1	1	1	1	1	1	1	1	1	1	1	1	1	1	2	3	4	5	6	6	7	7	7	7	7	6	6	5	5	4	4	4	4	4	3	3	3	3	3	3	4	

1	1	1	1	1	1	1	1	1	1	1	1	1	1	1	1	1	1	1	1	1	1	1	1	2	3	4	5	6	7	7	7	7	7	6	6	6	5	5	4	4	4	4	4	4	3	3	3	3	4	

1	1	1	1	1	1	1	1	1	1	1	1	1	1	1	1	1	1	1	1	1	1	1	1	2	3	4	5	6	6	7	7	7	7	6	6	6	5	5	5	4	4	4	4	4	3	3	3	3	4	

1	1	1	1	1	1	1	1	1	1	1	1	1	1	1	1	1	1	1	1	1	1	1	1	2	3	4	5	6	6	6	7	7	6	6	6	5	5	5	5	4	4	4	4	4	3	3	3	3	4	

1	1	1	1	1	1	1	1	1	1	1	1	1	1	1	1	1	1	1	1	1	1	1	1	2	3	4	5	5	6	6	6	6	6	6	5	5	5	4	4	4	4	4	4	4	4	3	3	3	3	

1	1	1	1	1	1	1	1	1	1	1	1	1	1	1	1	1	1	1	1	1	1	1	1	2	3	3	4	5	5	5	5	5	5	5	4	4	4	4	4	4	4	4	4	4	4	3	3	3	3	

2	2	1	1	1	1	1	1	1	1	1	1	1	1	1	1	1	1	1	1	1	1	1	1	1	2	3	4	4	5	5	5	5	4	4	4	3	3	3	3	3	3	3	3	3	3	3	3	3	3	

2	2	1	1	1	1	1	1	1	1	1	1	1	1	1	1	1	1	1	1	1	1	1	1	1	1	2	3	3	4	4	4	4	3	3	3	2	2	2	3	3	3	3	3	3	3	3	3	3	2	

3	2	2	1	1	1	1	1	1	1	1	1	1	1	1	1	1	1	1	1	1	1	1	1	1	1	2	2	3	3	3	3	3	2	2	2	2	2	2	2	2	2	2	2	2	2	2	2	2	2	

3	3	2	2	1	1	1	1	1	1	1	1	1	1	1	1	1	1	1	1	1	1	1	1	1	1	1	2	2	2	3	2	2	2	1	1	1	1	1	1	1	1	1	1	1	1	1	1	1	1	

3	3	3	2	2	1	1	1	1	1	1	1	1	1	1	1	1	1	1	1	1	1	1	1	1	1	1	1	1	2	2	2	1	1	1	1	1	1	1	1	1	1	1	1	1	1	1	1	1	1	

3	3	3	3	2	2	1	1	1	1	1	1	1	1	1	1	1	1	1	1	1	1	1	1	1	1	1	1	1	1	1	1	1	1	1	1	1	1	1	1	1	1	1	1	1	1	1	1	1	1	

4	4	3	3	2	2	1	1	1	1	1	1	1	1	1	1	1	1	1	1	1	1	1	1	1	1	1	1	1	1	1	1	1	1	1	1	1	1	1	1	1	1	1	1	1	1	1	1	1	1	

4	4	3	3	2	2	1	1	1	1	1	1	1	1	1	1	1	1	1	1	1	1	1	1	1	1	1	1	1	1	1	1	1	1	1	1	1	1	1	1	1	1	1	1	1	1	1	1	1	1	

4	4	3	3	2	2	2	1	1	1	1	1	1	1	1	1	1	1	1	1	1	1	1	1	1	1	1	1	1	1	1	1	1	1	1	1	1	1	1	1	1	1	1	1	1	1	1	1	1	1	

4	4	4	3	3	3	2	2	2	2	2	2	2	1	1	1	1	1	1	1	1	1	1	1	1	1	1	1	1	2	2	2	1	1	1	1	1	1	1	1	1	1	1	1	1	1	1	1	1	1	

4	4	4	4	4	4	4	4	4	4	4	3	3	2	2	1	1	1	1	1	1	1	1	1	1	1	1	1	1	2	2	2	2	1	1	1	1	1	1	1	1	1	1	1	1	1	1	2	2	2	

5	5	5	5	5	5	5	5	6	5	5	5	5	4	4	3	3	3	2	2	2	2	2	2	2	2	1	1	2	2	2	2	2	2	1	1	1	1	1	1	1	1	1	1	1	1	2	2	3	3	

6	6	6	6	6	6	7	7	7	7	7	7	7	6	6	5	5	4	4	4	4	3	3	3	3	2	2	2	2	2	2	2	2	2	1	1	1	1	1	1	1	1	1	1	1	2	3	3	4	4	

6	6	6	6	7	7	8	8	9	9	9	9	8	8	7	7	6	6	5	5	5	5	5	5	4	3	3	2	2	2	2	2	2	2	1	1	1	1	1	1	1	1	1	1	2	3	3	4	4	5	

6	6	6	7	7	8	8	9	9	10	10	10	9	9	8	8	7	7	6	6	6	6	6	6	5	4	3	3	2	2	2	2	2	2	1	1	1	1	1	1	1	1	1	2	2	3	4	5	5	5	

6	6	6	6	7	8	8	9	10	10	10	10	10	10	9	8	8	7	7	7	7	7	7	6	6	5	4	3	2	2	2	2	2	2	1	1	1	1	1	1	1	1	2	2	3	4	4	5	5	5	

6	6	6	6	7	8	8	9	10	10	11	11	10	10	9	9	8	8	7	7	7	7	7	6	6	5	4	3	2	2	2	2	2	2	1	1	1	1	1	1	1	1	2	2	3	4	4	5	5	5	

6	6	6	6	7	7	8	9	10	10	11	11	10	10	10	9	8	8	7	7	7	7	7	7	6	5	4	3	3	2	2	2	2	2	1	1	1	1	1	1	1	1	2	3	3	4	5	5	5	5	

6	6	6	6	7	7	8	9	10	11	11	11	11	10	10	9	8	8	8	7	7	7	7	7	6	5	4	3	3	2	2	2	2	1	1	1	1	1	1	1	1	1	2	3	4	5	5	6	6	6	

5	5	5	6	6	7	8	9	10	11	11	11	11	11	10	10	9	9	8	8	8	8	8	7	6	5	4	3	3	2	2	2	1	1	1	1	1	1	1	2	2	2	3	4	5	6	6	7	7	7	

5	5	5	6	7	8	9	10	11	11	12	12	12	11	11	10	10	9	9	8	8	8	8	8	7	6	5	4	3	2	2	2	1	1	1	1	1	1	2	2	2	3	3	5	6	7	7	8	8	8	

5	5	5	6	7	8	9	10	11	12	12	12	12	12	11	11	10	10	9	9	9	9	9	8	8	6	5	4	3	2	2	2	1	1	1	1	1	2	2	3	3	3	4	5	6	7	8	9	9	9	

4	5	5	6	7	8	9	11	12	13	13	13	13	12	12	11	11	10	10	10	10	10	9	9	8	7	6	4	3	2	2	2	1	1	1	2	2	3	3	3	4	4	5	6	7	8	9	10	10	10	

5	5	5	6	7	9	10	12	13	14	14	14	14	14	13	12	12	11	11	11	11	10	10	9	8	7	6	5	3	2	2	2	2	2	2	2	3	3	4	4	4	5	5	7	8	9	10	11	11	12	

5	5	6	7	8	9	11	12	14	15	15	15	15	15	14	13	13	12	11	11	11	11	11	10	9	8	6	5	4	3	2	2	2	2	2	3	3	4	5	5	5	5	6	7	9	10	11	12	13	13	

5	5	6	7	9	10	12	13	15	16	16	16	16	15	15	14	13	13	12	12	12	11	11	10	9	8	6	5	4	3	2	2	2	2	3	3	4	4	5	5	5	6	7	8	9	11	12	13	14	14	

