2	2	2	1	1	1	1	1	1	1	1	1	1	1	1	1	1	1	1	1	1	1	1	1	2	3	3	3	4	4	3	3	3	2	1	1	1	1	1	1	

2	2	2	1	1	1	1	1	1	1	1	1	1	1	1	1	1	1	1	1	1	1	1	1	2	3	3	3	4	4	4	3	3	2	1	1	1	1	1	1	

2	2	2	1	1	1	1	1	1	1	1	1	1	1	1	1	1	1	1	1	1	1	1	1	1	2	3	3	4	4	4	4	3	3	2	1	1	1	1	1	

3	3	2	2	1	1	1	1	1	1	1	1	1	1	1	1	1	1	1	1	1	1	1	1	1	2	3	3	4	4	4	4	4	3	3	2	1	1	1	1	

3	3	3	2	1	1	1	1	1	1	1	1	1	1	1	1	1	1	1	1	1	1	1	1	1	2	3	4	5	5	5	5	5	4	4	3	2	1	1	1	

3	3	3	2	1	1	1	1	1	1	1	1	1	1	1	1	1	1	1	1	1	1	1	1	1	2	3	4	5	6	6	6	6	5	4	3	2	2	1	1	

4	4	3	3	2	1	1	1	1	1	1	1	1	1	1	1	1	1	1	1	1	1	1	1	1	2	4	5	6	7	7	7	6	6	5	4	3	2	2	1	

5	5	4	3	2	1	1	1	1	1	1	1	1	1	1	1	1	1	1	1	1	1	1	1	1	3	4	6	7	8	8	8	7	6	6	5	4	3	2	2	

6	5	5	4	3	1	1	1	1	1	1	1	1	1	1	1	1	1	1	1	1	1	1	1	2	3	5	6	8	8	8	8	7	7	6	5	4	3	3	2	

6	6	6	5	3	2	1	1	1	1	1	1	1	1	1	1	1	1	1	1	1	1	1	1	2	4	5	7	8	8	8	8	7	7	6	5	4	4	3	3	

7	6	6	5	3	2	1	1	1	1	1	1	1	1	1	1	1	1	1	1	1	1	1	1	2	4	5	7	8	8	8	8	7	7	6	5	4	4	3	3	

7	6	6	5	4	2	1	1	1	1	1	1	1	1	1	1	1	1	1	1	1	1	1	1	2	4	5	7	8	8	8	8	7	7	6	5	4	4	3	3	

7	7	6	5	4	2	1	1	1	1	1	1	1	1	1	1	1	1	1	1	1	1	1	1	2	4	6	7	8	8	8	8	8	7	6	6	5	4	4	3	

8	7	7	6	4	3	1	1	1	1	1	1	1	1	1	1	1	1	1	1	1	1	1	2	3	4	6	7	8	9	9	9	8	8	7	6	6	5	5	5	

9	8	8	6	5	4	2	1	1	1	1	1	1	1	1	1	1	1	1	1	1	1	1	2	3	5	6	8	9	9	9	9	9	8	8	7	7	6	6	6	

10	10	9	8	6	5	3	2	1	1	1	1	1	1	1	1	1	1	1	1	1	1	1	2	4	5	7	8	10	10	10	10	10	9	9	8	8	8	8	7	

11	11	10	9	7	6	4	3	2	1	1	1	1	1	2	2	2	1	1	1	1	1	2	3	4	6	8	9	10	11	11	11	11	10	10	10	10	10	9	9	

12	12	11	10	8	7	5	4	3	2	2	2	2	2	2	2	2	2	1	1	1	1	2	3	4	6	8	10	11	11	12	12	11	11	11	11	11	11	11	11	

12	12	11	10	9	7	6	4	3	3	3	3	3	3	3	2	2	2	1	1	1	1	2	3	4	6	8	10	11	12	12	12	12	12	12	13	13	13	13	13	

12	12	11	10	9	8	6	5	4	3	3	3	3	3	3	3	2	2	1	1	1	1	2	3	4	6	8	10	12	12	13	13	13	13	13	13	14	14	14	14	

12	12	11	11	9	8	6	5	4	3	3	3	3	3	3	3	2	2	1	1	1	1	2	3	4	6	8	10	12	13	13	13	13	13	14	14	14	14	15	15	

12	12	12	11	10	8	7	5	4	4	4	4	3	3	3	3	2	2	1	1	1	1	2	3	5	6	8	10	12	13	13	13	13	13	14	14	14	15	15	15	

12	12	12	11	10	9	8	6	5	5	5	4	4	4	4	3	3	2	2	1	1	1	2	4	5	7	9	10	12	13	13	13	13	14	14	14	15	15	15	15	

13	13	13	12	11	10	9	7	7	6	6	6	5	5	4	4	4	3	2	2	2	2	3	4	6	7	9	11	12	13	13	13	13	14	14	15	15	15	16	16	

14	14	14	13	13	11	10	9	8	7	7	7	7	6	5	5	4	4	3	3	2	3	3	5	6	8	9	11	12	13	13	13	14	14	14	15	15	16	16	17	

15	15	15	14	13	12	11	10	9	9	9	9	8	7	6	6	5	5	4	3	3	3	4	5	7	8	9	11	12	13	13	13	13	14	14	15	15	16	17	17	

16	16	16	15	14	13	12	11	11	10	10	10	9	9	8	7	6	5	5	4	4	4	5	6	7	8	10	11	12	13	13	13	13	14	14	15	16	16	17	18	

17	17	17	16	16	15	13	13	12	12	12	12	11	10	9	8	7	6	6	5	5	5	6	7	8	9	10	11	12	12	13	13	13	13	14	15	16	17	17	18	

17	17	17	17	17	16	15	14	13	13	13	13	13	12	11	10	9	8	7	6	6	6	7	8	9	10	11	12	12	12	13	13	13	13	14	15	16	17	18	18	

18	18	18	18	17	16	15	15	15	14	14	14	14	13	12	11	10	9	8	7	7	7	8	9	10	11	12	12	12	13	13	13	13	13	14	15	16	17	18	19	

18	18	18	18	18	17	16	15	15	15	15	15	14	13	12	11	10	9	8	8	7	8	8	9	10	11	12	12	13	13	13	13	13	13	14	15	16	17	18	19	

19	19	19	18	18	17	16	15	15	15	15	15	14	13	12	11	10	9	8	8	8	8	9	9	10	11	12	12	12	12	12	12	13	13	14	15	16	17	18	19	

19	19	19	19	18	17	16	16	16	15	15	15	15	14	13	12	11	10	9	9	8	9	9	10	10	11	11	12	12	12	12	12	12	13	13	14	15	16	17	18	

19	19	19	19	19	18	17	16	16	16	16	16	16	15	14	13	12	11	10	10	10	10	10	10	11	11	11	11	11	11	11	11	11	12	13	13	14	15	17	17	

19	19	19	19	19	18	17	17	17	17	17	17	16	16	15	14	13	12	11	11	11	11	11	11	11	11	11	11	10	10	10	10	10	11	12	12	13	14	16	16	

19	19	19	19	19	19	18	18	18	18	18	17	17	16	16	15	14	13	12	12	11	12	12	11	11	11	11	10	9	9	9	9	10	10	11	11	12	13	14	15	

19	19	19	19	19	19	19	18	18	18	18	18	18	17	16	15	14	13	13	12	12	12	12	12	11	11	10	9	9	8	8	8	9	9	10	10	11	12	13	14	

19	19	20	20	19	19	19	18	18	18	18	18	18	18	17	16	15	14	13	13	13	13	12	12	11	10	10	9	8	7	7	7	8	8	9	9	10	11	12	12	

20	20	20	20	20	19	19	19	18	18	18	18	18	18	17	16	15	15	14	14	13	13	13	12	11	10	9	8	7	6	6	6	7	7	8	9	9	10	11	12	

20	20	20	20	20	20	19	19	18	18	18	18	18	18	17	17	16	15	14	14	14	13	13	12	10	10	9	8	6	6	5	6	6	7	8	8	9	10	10	11	

20	20	20	20	20	20	19	19	18	18	18	18	18	18	18	17	16	15	14	14	14	14	13	12	10	10	9	7	6	6	5	5	6	7	8	8	9	9	10	11	

20	20	20	20	20	20	19	19	18	18	18	18	18	18	18	17	16	15	14	14	14	14	13	12	11	10	9	7	6	6	5	5	6	7	8	8	9	9	10	11	

20	20	20	20	19	19	19	19	19	18	18	18	18	18	18	17	16	15	15	15	14	14	14	12	11	10	9	8	6	5	5	5	6	7	7	8	8	9	10	10	

21	20	20	20	19	19	19	19	19	18	18	18	18	19	19	18	17	16	16	15	15	15	14	13	11	10	9	8	6	5	5	5	6	6	7	7	7	8	9	9	

21	21	20	20	19	19	19	19	19	19	18	19	19	19	19	19	18	17	16	16	16	16	15	13	11	10	9	8	6	5	5	5	5	6	6	6	7	7	8	8	

21	21	21	20	20	19	20	20	20	19	19	19	20	20	20	20	18	18	17	17	17	16	15	14	12	10	9	8	6	5	5	5	5	5	6	6	6	7	7	8	

22	22	21	20	20	20	20	20	20	20	20	20	21	21	21	20	19	18	18	17	17	17	16	14	13	11	10	8	6	5	5	5	5	5	5	5	6	6	7	7	

22	22	21	20	20	20	20	21	21	21	21	21	21	22	21	21	19	19	18	18	18	18	17	15	13	12	10	8	7	5	5	5	5	5	5	5	5	6	6	6	

22	22	21	21	20	20	21	21	21	21	21	21	22	22	22	21	20	19	18	18	18	18	17	15	14	12	11	9	7	6	5	5	5	5	5	5	5	5	6	6	

22	22	21	21	20	20	21	21	22	22	22	22	22	22	22	21	20	19	19	19	19	18	17	16	14	12	11	9	7	6	5	5	5	5	5	5	5	5	5	5	

22	22	21	21	20	20	21	22	22	22	22	22	22	22	22	21	20	19	19	19	19	19	18	16	14	12	11	9	7	6	5	5	5	5	4	4	5	5	5	5	

22	22	21	20	20	20	21	21	22	22	22	22	22	22	22	21	20	19	19	19	19	19	18	16	14	12	11	9	7	6	5	5	5	5	5	5	5	5	5	5	

21	21	20	20	20	20	21	21	22	22	22	22	22	22	21	21	20	19	19	19	19	18	17	16	14	12	11	9	8	6	6	6	6	6	6	6	6	6	6	6	

20	20	20	19	19	20	20	21	21	21	22	22	21	21	21	20	19	19	18	18	18	18	17	16	14	13	11	10	8	7	7	7	7	7	7	6	6	6	6	6	

19	19	19	18	18	19	20	20	21	21	21	21	21	21	21	20	19	19	18	18	18	18	17	16	15	13	12	10	9	8	8	8	8	7	7	7	7	7	7	6	

18	18	18	18	18	18	19	20	21	21	21	21	21	20	20	20	19	19	18	18	18	18	17	16	15	14	12	11	9	9	8	8	8	8	8	8	8	7	7	7	

17	17	17	17	17	17	18	19	20	20	20	20	20	20	20	20	19	19	18	18	18	18	17	16	15	14	13	11	10	9	9	9	9	8	8	8	8	8	7	7	

16	16	15	16	16	17	18	18	19	20	20	20	20	20	20	20	19	19	19	18	18	18	18	17	16	14	13	12	11	10	9	9	9	9	8	8	8	8	7	7	

14	14	14	15	15	16	17	18	19	19	20	20	20	20	20	20	19	19	19	19	18	18	18	17	16	15	13	12	11	10	10	10	10	9	9	9	8	8	8	7	

13	13	14	14	15	16	16	18	19	19	19	19	20	20	20	20	19	19	19	18	18	18	18	17	16	15	14	12	11	11	10	10	10	9	9	9	9	8	8	7	

13	13	13	14	15	15	16	17	19	19	19	19	19	20	20	20	19	19	19	18	18	18	18	17	16	15	14	12	11	11	10	10	10	9	9	9	9	8	8	7	

12	13	13	14	14	15	16	17	19	19	19	19	19	20	20	20	19	19	19	18	18	18	18	17	16	15	13	12	11	11	10	10	10	9	9	8	8	8	7	7	

12	12	12	13	14	15	16	17	18	19	19	19	19	19	19	19	19	19	18	18	18	18	17	16	15	14	13	12	11	10	10	10	9	8	8	8	7	7	6	6	

11	11	11	12	13	14	15	16	17	18	18	18	19	19	19	19	18	18	18	18	18	17	17	16	15	14	13	11	10	9	9	9	8	8	7	6	6	5	5	4	

9	9	10	11	12	13	14	15	17	17	18	18	18	18	18	18	18	18	18	18	18	17	17	16	14	13	12	11	9	9	8	8	7	7	6	5	4	4	3	3	

8	8	8	9	10	11	12	14	15	16	17	17	17	17	18	18	18	18	18	18	18	17	16	15	14	13	11	10	9	8	8	8	7	6	5	4	3	2	2	1	

7	7	7	8	9	10	11	13	14	15	15	15	16	16	17	17	17	17	17	17	17	17	16	15	14	12	11	9	8	7	7	7	6	5	4	3	2	1	1	1	

6	6	6	6	7	8	10	11	13	13	14	14	14	15	15	16	16	16	17	17	17	17	16	14	13	11	10	8	7	7	6	6	5	4	3	2	1	1	1	1	

5	5	5	5	6	7	9	10	11	12	12	12	13	14	14	15	15	16	16	16	17	16	15	14	12	10	9	8	6	6	5	5	5	3	2	1	1	1	1	1	

4	4	4	4	5	6	8	9	10	11	11	11	12	13	14	14	14	15	16	16	16	16	15	13	11	10	8	7	6	5	5	5	4	3	2	1	1	1	1	1	

4	4	4	4	5	6	7	9	10	10	11	11	12	13	13	14	14	15	15	16	16	15	14	13	11	9	8	7	6	5	5	4	4	3	2	1	1	1	1	1	

4	4	4	4	5	6	7	9	9	10	10	11	11	12	13	14	14	15	15	16	16	15	14	13	11	9	8	7	5	5	5	4	4	3	2	1	1	1	1	1	

4	4	4	4	5	6	7	8	9	10	10	10	11	12	13	13	14	14	15	15	15	15	14	12	11	9	8	6	5	4	4	4	4	3	1	1	1	1	1	1	

4	4	4	4	5	6	7	8	9	9	9	10	10	11	12	12	13	14	14	15	15	14	13	12	10	9	7	6	4	4	4	4	3	2	1	1	1	1	1	1	

4	4	4	4	5	6	7	8	8	9	9	9	9	10	11	11	12	13	14	14	14	14	12	11	9	8	6	5	4	3	3	3	2	1	1	1	1	1	1	1	

4	4	4	4	5	6	7	8	8	8	8	8	9	10	10	11	11	12	13	13	14	13	12	10	8	7	5	4	3	2	2	2	1	1	1	1	1	1	1	1	

3	4	4	4	5	6	7	8	8	8	8	8	9	9	10	10	11	12	12	13	13	12	11	9	8	6	4	3	2	1	1	1	1	1	1	1	1	1	1	1	

4	4	4	5	6	7	8	8	8	8	8	8	9	9	10	10	11	11	12	12	12	12	11	9	7	6	4	3	1	1	1	1	1	1	1	1	1	1	1	1	

4	4	5	5	6	7	8	9	9	9	9	9	9	9	9	10	10	11	12	12	12	12	10	9	7	6	4	2	1	1	1	1	1	1	1	1	1	1	1	1	

4	4	5	6	7	8	9	9	9	9	9	9	9	9	9	10	10	11	11	12	12	12	10	9	7	6	4	2	1	1	1	1	1	1	1	1	1	1	1	1	

