1	1	1	1	1	1	1	2	2	2	2	2	2	2	2	2	2	2	2	2	2	2	2	3	4	5	6	7	8	9	9	9	10	10	11	12	13	13	14	14	

1	1	1	1	1	1	1	2	2	2	2	2	2	2	2	2	3	3	2	2	2	2	2	3	4	5	6	7	8	9	9	9	9	10	11	11	12	13	14	14	

1	1	1	1	1	1	1	2	2	2	2	2	3	3	3	3	3	3	3	3	3	3	3	3	4	5	6	7	7	8	8	8	9	9	10	10	11	12	12	13	

1	1	1	1	1	1	1	2	2	2	3	3	3	3	4	4	4	4	4	4	3	3	3	4	4	5	5	6	7	7	7	7	8	8	9	9	9	10	11	11	

1	1	1	1	1	1	2	2	3	3	3	3	3	4	4	5	5	5	5	5	5	4	4	4	4	4	5	5	6	6	6	6	6	7	7	8	8	8	9	9	

1	1	1	1	1	1	2	3	3	4	4	4	4	5	5	6	6	6	6	6	6	6	5	5	5	5	5	5	5	5	5	5	6	6	6	6	7	7	7	8	

1	1	1	1	1	1	2	3	4	4	4	4	5	5	6	7	7	8	7	7	7	7	7	6	6	5	5	5	5	5	5	5	5	5	5	5	5	6	6	6	

1	1	1	1	1	1	2	3	4	4	4	4	5	6	7	7	8	8	9	9	9	9	8	7	7	6	6	6	5	5	5	5	5	5	5	4	4	4	5	5	

1	1	1	1	1	1	2	3	4	4	4	4	5	6	7	8	8	9	9	10	10	10	9	8	7	7	6	6	5	5	5	5	4	4	4	3	3	3	3	3	

1	1	1	1	1	1	2	3	3	4	4	4	5	6	7	8	9	9	10	10	11	10	10	9	8	7	7	6	6	5	5	4	4	4	3	2	2	2	2	2	

1	1	1	1	1	1	2	3	3	4	4	4	5	6	7	8	9	9	10	11	11	11	10	9	8	8	7	6	6	5	5	4	4	3	3	2	2	2	2	2	

1	1	1	1	1	1	2	3	3	4	4	4	5	6	7	8	9	9	10	11	11	11	10	9	9	8	7	7	6	5	5	5	4	4	3	2	2	2	2	2	

1	1	1	1	1	1	1	2	3	3	3	3	4	5	6	7	8	9	10	10	11	11	10	9	9	8	8	7	7	6	6	6	5	5	4	3	3	3	3	3	

1	1	1	1	1	1	1	1	2	2	2	2	3	4	5	7	8	9	10	10	10	10	10	9	9	9	8	8	8	7	7	7	6	6	5	4	4	4	4	4	

1	1	1	1	1	1	1	1	1	1	1	1	2	3	4	6	7	8	9	10	10	10	10	9	9	9	9	9	8	8	8	8	7	7	6	5	5	5	5	5	

1	1	1	1	1	1	1	1	1	1	1	1	1	2	3	5	6	8	9	9	10	9	9	9	9	9	9	9	9	9	9	9	8	8	7	6	6	6	5	5	

1	1	1	1	1	1	1	1	1	1	1	1	1	1	2	4	5	7	8	9	9	9	9	9	9	9	9	9	10	10	10	10	9	9	8	7	7	6	6	6	

1	1	1	1	1	1	1	1	1	1	1	1	1	1	1	3	4	6	7	8	8	8	8	8	9	9	9	10	10	11	11	11	10	10	9	8	8	7	7	7	

1	1	1	1	1	1	1	1	1	1	1	1	1	1	1	2	4	5	6	7	7	7	8	8	8	9	9	10	11	12	12	12	11	11	10	10	9	8	8	7	

1	1	1	1	1	1	1	1	1	1	1	1	1	1	1	1	3	5	6	6	7	7	7	8	8	9	9	10	12	12	13	12	12	12	11	11	10	9	8	8	

1	1	1	1	1	1	1	1	1	1	1	1	1	1	1	1	3	4	5	6	6	7	7	8	8	9	9	11	12	13	13	13	13	12	12	11	10	9	8	8	

1	1	1	1	1	1	1	1	1	1	1	1	1	1	1	1	3	4	5	6	6	6	7	7	8	9	9	11	12	13	13	13	13	12	12	11	10	10	9	8	

1	1	1	1	1	1	1	1	1	1	1	1	1	1	1	1	3	4	5	5	6	6	6	7	7	8	9	11	12	13	13	13	13	12	12	11	11	10	9	9	

1	1	1	1	1	1	1	1	1	1	1	1	1	1	1	1	2	3	4	5	5	5	5	6	7	8	9	10	12	13	13	13	13	13	13	12	11	11	10	10	

1	1	1	1	1	1	1	1	1	1	1	1	1	1	1	1	2	3	3	4	4	4	5	5	6	7	9	10	12	13	13	13	13	13	13	13	12	12	11	11	

1	1	1	1	1	1	1	1	1	1	1	1	1	1	1	1	1	2	2	3	3	3	4	5	6	7	8	10	12	13	13	13	14	14	14	14	13	13	13	12	

1	1	1	1	1	1	1	1	1	1	1	1	1	1	1	1	1	1	2	2	2	2	3	4	5	6	8	10	11	13	13	13	14	14	14	15	14	14	14	14	

1	1	1	1	1	1	1	1	1	1	1	1	1	1	1	1	1	1	1	1	1	1	2	3	4	6	7	9	11	12	13	13	14	14	15	15	15	15	15	15	

1	1	1	1	1	1	1	1	1	1	1	1	1	1	1	1	1	1	1	1	1	1	1	2	4	5	7	9	10	12	12	13	13	14	15	15	15	16	16	16	

1	1	1	1	1	1	1	1	1	1	1	1	1	1	1	1	1	1	1	1	1	1	1	2	3	5	7	8	10	11	12	12	13	14	14	15	15	16	16	17	

1	1	1	1	1	1	1	1	1	1	1	1	1	1	1	1	1	1	1	1	1	1	1	2	3	5	6	8	10	11	12	12	13	13	14	15	16	16	17	17	

1	1	1	1	1	1	1	1	1	1	1	1	1	1	1	1	1	1	1	1	1	1	1	1	3	4	6	8	10	11	11	11	12	13	14	15	15	16	17	17	

1	1	1	1	1	1	1	1	1	1	1	1	1	1	1	1	1	1	1	1	1	1	1	1	3	4	6	7	9	10	10	10	11	12	13	14	14	15	16	17	

1	1	1	1	1	1	1	1	1	1	1	1	1	1	1	1	1	1	1	1	1	1	1	1	2	3	5	6	8	8	8	8	9	10	11	12	13	14	15	16	

1	1	1	1	1	1	1	1	1	1	1	1	1	1	1	1	1	1	1	1	1	1	1	1	1	2	4	5	6	6	6	7	7	8	10	11	11	13	14	15	

1	1	1	1	1	1	1	1	1	1	1	1	1	1	1	1	1	1	1	1	1	1	1	1	1	1	3	4	4	5	5	5	6	7	8	9	10	11	13	14	

3	3	2	2	1	1	1	1	1	1	1	1	1	1	1	1	1	1	1	1	1	1	1	1	1	1	1	2	3	3	3	4	4	5	7	7	9	10	11	13	

4	4	4	3	2	1	1	1	1	1	1	1	1	1	1	1	1	1	1	1	1	1	1	1	1	1	1	1	2	2	2	2	3	4	5	6	7	9	10	11	

5	5	5	4	3	2	2	1	1	1	1	1	1	1	1	1	1	1	1	1	1	1	1	1	1	1	1	1	1	1	1	1	2	3	4	5	6	7	9	10	

6	6	6	5	4	3	2	2	2	2	2	2	1	1	1	1	1	1	1	1	1	1	1	1	1	1	1	1	1	1	1	1	1	2	3	4	5	6	8	9	

