7	7	6	5	4	3	2	1	1	1	1	1	1	1	1	1	1	1	1	1	1	1	1	1	2	3	4	5	5	5	5	5	5	6	6	7	8	9	10	11	11	11	11	10	10	9	8	7	7	7	

7	7	6	5	4	3	2	1	1	1	1	1	1	1	1	1	1	1	1	1	1	1	1	1	2	3	4	5	5	5	5	5	6	6	6	7	8	10	10	11	11	11	11	11	10	9	8	7	7	7	

8	7	7	6	5	4	2	1	1	1	1	1	1	1	1	1	1	1	1	1	1	1	1	1	2	4	5	5	6	6	6	6	6	7	7	8	9	10	11	12	12	12	12	11	10	9	9	8	7	7	

8	8	7	7	6	4	3	2	1	1	1	1	1	1	1	1	1	1	1	1	1	1	1	2	3	5	6	6	7	7	7	7	7	8	8	9	10	12	13	13	14	13	13	12	11	10	9	8	8	8	

9	9	8	8	7	6	5	3	3	2	2	2	2	1	1	1	1	1	1	2	2	2	3	4	5	6	7	8	8	8	8	9	9	9	10	11	12	13	14	15	15	15	15	14	12	11	10	9	8	8	

10	10	10	9	8	7	6	5	4	3	3	3	3	3	3	2	3	3	3	4	4	4	5	6	7	8	9	10	10	10	10	10	11	11	12	13	14	15	16	16	17	16	16	15	14	12	11	10	9	9	

12	12	11	10	10	8	7	6	5	5	5	5	5	4	4	4	4	5	5	6	6	6	6	7	8	10	11	11	12	12	12	12	13	13	14	14	15	16	17	18	18	18	17	16	15	13	12	11	10	9	

13	13	13	12	11	10	9	8	7	6	6	6	6	6	6	6	6	6	7	7	7	7	8	9	10	11	12	13	13	14	14	14	14	14	15	16	16	17	18	19	19	19	18	17	15	14	13	11	10	9	

14	14	14	13	12	11	10	9	8	7	7	7	7	7	7	7	7	7	8	8	8	8	8	9	10	12	13	14	14	15	15	15	15	16	16	17	17	18	19	19	19	19	18	17	16	14	13	11	10	9	

15	15	15	14	13	12	11	10	9	8	8	8	8	8	8	8	8	8	8	8	8	9	9	10	11	12	13	14	15	15	15	16	16	16	17	17	18	18	19	19	20	19	19	17	16	14	13	11	10	9	

16	16	15	14	13	12	11	10	9	9	8	8	8	8	8	8	8	8	8	9	9	9	9	10	11	12	13	15	15	16	16	16	16	16	17	18	18	19	19	20	20	19	19	17	16	14	13	11	10	9	

16	16	15	14	14	13	12	10	9	9	9	8	8	8	8	8	8	9	9	9	9	9	9	10	11	12	13	14	15	16	16	16	16	16	17	18	18	19	19	20	20	19	19	17	16	14	13	11	10	9	

16	16	15	15	14	13	12	11	10	9	9	9	9	8	8	8	9	9	9	9	9	9	9	10	11	12	13	14	15	15	16	16	16	17	17	18	18	19	19	19	19	19	18	17	16	14	13	11	10	10	

16	16	16	15	14	14	13	12	10	10	10	9	9	9	9	9	9	9	9	9	9	9	9	10	11	12	13	14	15	15	16	16	16	17	17	18	18	19	19	19	19	19	18	17	16	14	13	11	10	10	

16	16	16	16	15	14	13	12	11	10	10	10	10	9	9	10	10	10	10	9	9	9	9	10	11	12	13	14	15	15	16	16	16	17	18	18	18	19	19	19	19	19	18	17	16	14	13	12	10	10	

16	16	16	16	15	15	14	13	12	11	10	10	10	10	10	10	11	11	10	10	10	10	10	10	11	12	13	14	15	16	16	16	16	17	18	18	18	19	19	19	19	19	18	17	16	14	13	12	11	10	

16	16	16	16	15	15	14	13	12	11	11	11	11	10	11	11	11	11	11	11	11	11	11	11	12	12	13	14	15	16	16	16	17	17	18	18	19	19	19	19	19	19	18	17	16	14	13	12	11	10	

16	16	16	16	15	15	14	13	12	11	11	11	11	11	11	11	12	12	12	11	11	11	11	12	12	13	14	15	15	16	16	16	17	17	18	18	19	19	19	19	20	19	18	17	16	15	13	12	11	11	

15	15	15	15	15	15	14	13	12	12	11	11	11	11	11	12	12	12	12	12	12	12	12	12	13	13	14	15	15	16	16	16	17	17	18	18	19	19	19	20	20	19	19	17	16	15	14	12	12	11	

15	15	15	15	15	14	14	13	12	12	11	11	11	11	11	12	12	12	12	12	12	12	12	13	13	14	14	15	16	16	16	16	17	17	18	18	19	19	19	20	20	20	19	18	16	15	14	13	12	11	

15	15	15	15	15	14	14	13	12	12	11	11	12	11	12	12	12	12	12	12	12	12	13	13	13	14	15	15	16	16	16	16	17	17	18	18	19	19	20	20	20	20	19	18	16	15	14	13	12	11	

14	14	14	15	15	14	13	12	12	11	11	11	11	11	11	12	12	12	12	12	12	12	12	13	13	14	14	15	16	16	16	16	17	17	18	18	18	19	19	20	20	19	19	18	16	15	14	12	12	11	

13	13	13	14	13	13	12	11	11	10	10	10	10	10	10	11	11	11	12	12	11	12	12	12	13	14	14	15	15	15	16	16	16	17	17	18	18	18	19	19	19	19	18	17	15	14	13	12	11	11	

12	12	12	12	12	11	11	10	9	9	9	9	9	9	9	10	10	10	11	11	11	11	11	12	12	13	14	14	14	15	15	15	15	16	16	17	17	17	18	18	18	18	17	16	15	13	12	11	11	11	

10	10	10	10	10	10	9	8	8	7	7	7	7	7	8	8	9	9	10	10	10	10	10	11	11	12	13	13	13	14	14	14	14	14	15	15	16	16	16	17	17	17	16	15	14	12	11	10	10	10	

9	9	9	9	9	8	8	7	7	6	6	6	6	6	6	7	7	8	8	9	9	9	9	9	10	11	11	12	12	12	13	13	13	13	14	14	15	15	15	16	16	16	15	14	13	11	10	9	9	9	

8	8	8	8	7	7	7	6	5	5	5	5	5	5	5	5	6	7	7	7	7	8	8	8	9	9	10	11	11	11	11	11	12	12	13	13	14	14	15	15	15	15	14	13	12	10	9	8	8	8	

7	7	7	7	6	6	5	5	4	4	4	4	4	4	4	5	5	6	6	6	7	7	7	7	8	8	9	9	10	10	10	10	11	11	12	12	13	13	14	14	14	13	13	12	10	9	8	7	7	7	

6	6	6	6	5	5	4	4	4	3	3	3	3	4	4	4	5	5	5	6	6	6	6	6	7	7	8	9	9	9	10	10	10	10	11	12	12	13	13	13	13	13	12	11	10	8	7	7	6	7	

5	5	5	5	5	4	4	3	3	3	3	3	3	4	4	4	5	5	5	5	5	5	5	6	6	7	7	8	9	9	9	9	9	10	11	11	12	12	12	12	12	12	11	10	9	8	7	6	6	6	

5	5	5	5	4	4	3	3	3	3	3	3	3	4	4	4	5	5	5	5	5	5	5	5	6	6	7	8	8	9	9	9	9	10	11	11	12	12	12	12	12	12	11	10	9	8	7	6	6	6	

5	5	5	5	4	4	3	3	3	3	3	3	3	4	4	5	5	5	5	5	5	5	5	5	6	6	7	8	8	9	9	9	10	10	11	11	12	12	12	12	12	12	11	10	9	8	7	6	6	6	

5	5	5	5	5	4	4	4	4	4	4	4	4	4	5	5	6	6	6	5	5	5	5	6	6	7	7	8	9	9	10	10	10	11	11	12	12	13	13	12	12	12	12	11	10	8	7	6	6	6	

5	5	5	5	5	5	4	4	4	5	5	5	5	5	6	6	6	6	6	6	6	6	6	6	6	7	8	9	9	10	10	10	11	11	12	12	13	13	13	13	13	12	12	11	10	8	7	6	6	6	

5	5	5	5	5	5	5	5	5	5	5	5	6	6	6	7	7	7	7	6	6	6	6	6	7	7	8	9	10	11	11	11	11	12	12	13	13	13	13	13	13	12	12	11	10	8	7	6	6	5	

5	5	5	5	5	5	5	5	5	6	6	6	6	7	7	7	7	7	7	7	7	7	7	7	7	8	9	10	11	11	11	12	12	12	13	13	13	13	13	13	12	12	12	11	10	8	7	6	5	5	

5	5	5	5	5	5	5	5	6	6	6	6	7	7	7	8	8	8	7	7	7	7	7	8	8	9	9	10	11	12	12	12	12	13	13	13	13	13	13	12	12	12	12	11	9	8	6	5	5	4	

5	5	5	5	5	5	5	6	6	6	7	7	7	7	8	8	8	8	8	8	8	8	8	8	9	10	10	11	12	12	13	13	13	13	13	13	13	13	13	12	12	12	11	10	9	8	6	5	4	3	

5	5	5	5	5	6	6	6	6	7	7	7	7	8	8	8	9	9	9	9	9	9	9	9	10	11	11	12	13	13	13	13	13	13	14	14	14	13	13	13	12	12	12	11	9	8	6	5	4	3	

5	5	5	6	6	6	6	6	7	7	7	7	7	8	8	9	9	9	9	9	9	9	10	10	11	11	12	13	14	14	14	14	14	14	14	14	14	13	13	13	12	12	12	11	9	8	6	4	3	2	

5	5	6	6	6	6	6	6	7	7	7	7	7	8	8	9	9	9	10	10	10	10	10	10	11	12	12	13	14	14	14	14	14	14	14	14	14	13	13	13	12	12	12	10	9	7	6	4	3	2	

5	5	6	6	6	6	6	6	7	7	7	7	8	8	8	9	9	10	10	10	10	10	10	10	11	12	12	13	14	14	14	14	14	14	14	14	14	14	13	13	12	12	11	10	9	7	6	4	3	2	

5	5	6	6	6	6	7	7	7	8	8	8	8	8	9	9	10	10	10	10	10	10	10	11	11	12	13	13	14	14	14	14	14	14	14	14	14	13	13	12	12	12	11	10	9	7	6	4	3	2	

5	5	6	6	6	7	7	7	8	8	8	8	8	9	9	10	10	11	11	11	11	11	11	11	12	12	13	14	14	14	14	14	14	14	14	14	14	13	12	12	11	11	11	10	9	7	6	4	3	3	

5	5	5	6	6	7	7	8	8	9	9	9	9	9	10	10	11	11	12	12	12	12	12	12	12	13	13	14	14	14	15	14	14	14	14	13	13	12	12	11	11	11	10	10	9	7	6	5	4	3	

4	4	5	6	6	7	8	8	9	9	9	9	10	10	10	11	12	12	13	13	13	13	13	13	13	13	14	14	15	15	15	15	14	14	14	13	13	12	11	11	10	10	10	9	9	8	6	5	5	4	

4	4	4	5	6	7	8	8	9	9	10	10	10	10	11	12	12	13	13	14	14	14	14	14	14	14	14	15	15	15	15	15	15	14	14	13	12	12	11	10	10	10	10	9	9	8	7	6	5	5	

3	3	4	5	6	7	8	8	9	10	10	10	10	11	11	12	13	13	14	15	15	15	15	15	14	14	15	15	15	15	15	15	15	14	14	13	12	11	11	10	10	10	10	9	9	8	7	7	6	6	

3	3	4	5	6	7	8	9	9	10	10	10	10	11	11	12	13	14	14	15	15	15	15	15	15	15	15	15	15	15	15	15	15	14	14	13	12	11	11	10	10	10	10	9	9	8	8	7	7	6	

3	3	3	4	6	7	8	8	9	10	10	10	10	11	11	12	13	14	15	15	15	15	15	15	15	15	15	15	15	15	15	15	15	15	14	13	12	11	11	10	10	10	10	10	9	9	8	8	7	7	

