12	12	13	13	14	14	15	15	16	16	17	17	17	17	17	17	17	18	18	18	18	18	17	16	14	13	12	11	10	9	9	9	9	9	8	8	7	7	7	7	

12	12	13	13	14	14	15	15	16	16	17	17	17	17	17	17	17	18	18	18	18	18	17	16	15	13	12	11	10	9	9	9	9	9	8	8	7	7	7	7	

12	12	12	13	14	14	14	15	16	16	16	17	17	17	17	17	17	18	18	18	18	18	17	16	15	14	12	11	10	9	9	9	9	8	8	8	7	7	7	7	

12	12	12	13	13	14	14	15	15	16	16	16	17	17	17	17	18	18	18	18	19	18	17	16	15	14	12	11	10	9	9	9	9	8	8	8	7	7	7	7	

11	12	12	12	13	13	14	15	15	16	16	16	17	17	17	17	18	18	18	19	19	18	18	16	15	14	13	11	10	9	8	8	8	8	8	8	7	7	7	7	

11	11	11	12	12	13	14	15	15	16	16	16	17	17	17	18	18	18	19	19	19	19	18	17	15	14	13	11	10	9	8	8	8	8	8	7	7	7	7	6	

11	11	11	11	12	13	14	15	16	16	17	17	17	17	18	18	18	19	19	19	19	19	18	17	15	14	13	11	10	9	8	8	8	8	8	7	7	7	6	6	

10	11	11	12	12	13	14	15	16	17	17	17	17	17	18	18	18	18	19	19	19	19	18	17	15	14	13	11	10	9	8	8	8	8	8	7	7	6	6	6	

11	11	11	12	13	14	15	16	17	17	18	18	18	17	18	18	18	18	18	19	19	18	18	17	15	14	12	11	10	9	8	8	8	8	8	7	7	6	6	5	

11	11	11	12	13	14	15	17	17	18	18	18	18	18	18	18	18	18	18	18	18	18	17	16	15	14	12	11	9	9	8	8	8	8	8	7	7	6	6	5	

11	11	11	12	13	14	16	17	18	18	18	18	18	18	18	18	18	18	18	18	18	18	17	16	15	13	12	11	9	9	8	8	8	8	8	7	7	6	6	5	

11	11	11	12	13	14	15	17	18	18	18	18	18	18	18	18	18	18	18	18	18	18	17	16	15	13	12	10	9	8	8	8	8	8	8	7	7	6	6	5	

11	11	11	12	13	14	15	17	18	18	18	18	18	18	18	18	18	18	18	18	18	18	17	16	15	13	12	10	9	8	8	8	8	8	8	7	7	6	6	5	

11	11	11	12	13	14	15	17	17	18	18	18	17	17	17	17	17	17	17	17	17	17	16	15	14	13	11	10	8	8	7	7	8	8	8	7	7	6	6	5	

11	11	11	12	13	14	15	16	17	17	18	17	17	17	16	16	16	16	16	16	16	16	15	15	13	12	11	9	8	7	7	7	7	7	7	7	6	6	5	5	

11	11	12	12	13	14	15	16	17	17	17	17	17	16	16	16	15	15	15	15	15	15	14	13	12	11	10	8	7	6	6	6	7	7	7	6	6	6	5	5	

11	11	12	12	13	14	15	16	16	17	17	17	16	16	15	15	14	14	14	14	14	14	13	12	11	10	9	7	6	6	5	6	6	6	6	6	6	5	5	5	

12	12	12	12	13	13	14	15	15	16	16	16	15	15	14	14	13	13	13	13	13	13	13	12	11	10	8	7	6	5	5	5	5	5	5	5	5	5	5	5	

12	12	12	12	12	13	14	14	15	15	15	15	14	14	14	13	13	13	13	13	13	13	12	12	11	9	8	7	5	5	5	5	5	5	4	4	5	5	5	5	

12	12	12	12	12	13	13	14	14	14	14	14	14	14	13	13	12	12	12	13	13	12	12	11	11	9	8	7	5	5	4	4	4	4	4	4	4	5	5	5	

12	12	12	12	12	13	13	14	14	14	14	14	14	14	13	13	12	12	12	12	12	12	12	11	10	9	8	7	5	5	4	4	4	4	4	4	4	5	5	5	

12	12	12	12	12	13	13	14	14	14	14	14	14	14	13	13	12	12	12	12	12	12	12	11	10	9	8	7	6	5	5	5	4	4	4	4	4	5	5	5	

13	13	13	13	13	13	14	14	14	14	15	15	14	14	13	13	12	12	12	12	12	12	12	11	11	10	9	7	6	5	5	5	5	5	4	4	5	5	5	5	

14	14	14	13	13	13	14	14	14	15	15	15	15	14	14	13	12	12	12	12	12	12	12	11	11	10	9	8	7	6	6	6	5	5	5	5	5	5	6	6	

14	14	14	14	14	14	14	15	15	15	15	15	15	15	14	13	12	12	12	12	12	12	12	12	11	10	9	8	7	7	6	6	6	6	5	6	6	6	6	6	

15	15	15	15	15	15	15	15	15	15	16	15	15	15	14	13	12	12	12	12	12	12	12	12	11	10	10	9	8	7	7	7	7	6	6	6	7	7	7	7	

16	16	16	16	15	15	15	15	15	16	16	16	15	15	14	13	12	12	12	12	12	12	12	11	11	10	10	9	8	7	7	7	7	7	6	7	7	7	8	8	

17	17	17	16	16	16	16	16	16	16	16	16	15	15	14	13	13	12	12	12	12	12	11	11	11	10	9	9	8	7	7	7	7	7	7	7	8	8	9	9	

17	17	17	17	17	17	17	17	16	16	16	16	16	15	14	14	13	12	12	11	11	11	11	11	10	10	9	8	8	7	7	7	7	7	7	8	8	9	9	10	

18	18	18	17	17	17	17	17	17	17	17	16	16	15	15	14	13	12	12	11	11	11	10	10	10	9	9	8	7	7	7	7	7	7	7	8	9	9	10	10	

18	18	18	17	17	17	17	17	17	17	17	16	16	15	15	14	13	12	11	11	11	11	10	10	10	9	8	8	7	7	7	7	7	7	7	8	9	9	10	11	

18	18	17	17	17	17	17	16	16	16	16	16	16	15	14	13	12	12	11	11	11	11	10	10	9	9	8	8	7	7	6	6	7	7	7	8	9	9	10	11	

17	17	16	16	16	16	15	15	15	15	15	15	14	14	13	12	11	11	10	10	10	10	10	9	9	8	8	7	6	6	6	6	6	6	7	7	8	9	10	10	

16	16	15	15	14	14	14	14	13	13	13	13	13	12	11	11	10	9	9	9	9	9	9	9	8	8	7	6	6	5	5	5	5	5	6	7	7	8	9	10	

14	14	14	13	13	13	12	12	12	11	11	11	11	10	10	9	8	8	8	8	8	8	8	8	7	7	6	5	5	4	4	4	4	5	5	6	7	8	9	9	

12	12	12	12	11	11	11	10	10	10	9	9	9	9	8	8	7	7	7	7	7	7	7	7	7	6	5	5	4	3	3	3	3	4	4	5	6	7	8	9	

11	11	11	10	10	9	9	9	8	8	8	8	7	7	7	6	6	5	6	6	6	6	6	6	6	5	5	4	4	3	3	3	3	3	4	4	5	6	7	8	

10	10	10	9	8	8	8	7	7	6	6	6	6	5	5	5	4	4	4	5	5	5	5	5	5	5	4	4	3	2	2	2	2	3	3	4	5	6	7	7	

9	9	9	8	7	7	6	6	5	5	5	4	4	4	4	3	3	3	3	4	4	4	4	5	5	4	4	3	3	2	2	2	2	2	3	3	4	5	6	6	

9	9	8	7	6	6	6	5	4	4	4	3	3	3	2	2	2	2	3	3	3	3	4	4	4	4	3	3	2	2	2	2	2	2	2	3	4	5	6	6	

9	8	8	7	6	6	5	5	4	3	3	3	3	2	2	2	2	2	2	3	3	3	3	4	4	3	3	3	2	2	2	2	2	2	2	3	4	5	5	6	

8	8	7	7	6	5	5	4	4	3	3	3	2	2	2	2	2	2	2	3	3	3	3	3	3	3	3	2	2	2	2	2	2	2	2	3	4	5	6	6	

7	7	6	6	5	4	4	3	3	2	2	2	2	2	2	2	2	2	2	3	3	3	3	3	3	3	2	2	2	1	1	1	1	2	2	3	4	5	6	6	

5	5	4	4	3	3	2	2	2	1	1	1	1	1	1	1	2	2	2	2	2	2	2	2	2	2	2	2	1	1	1	1	1	2	3	3	4	5	6	6	

2	2	2	2	1	1	1	1	1	1	1	1	1	1	1	1	1	2	2	2	2	2	2	2	2	2	1	1	1	1	1	1	1	2	3	4	4	5	6	6	

1	1	1	1	1	1	1	1	1	1	1	1	1	1	1	1	1	1	2	2	2	2	2	2	1	1	1	1	1	1	1	1	1	2	3	4	4	5	6	6	

1	1	1	1	1	1	1	1	1	1	1	1	1	1	1	1	1	1	1	1	2	1	1	1	1	1	1	1	1	1	1	1	1	1	2	3	4	5	6	6	

1	1	1	1	1	1	1	1	1	1	1	1	1	1	1	1	1	1	1	1	1	1	1	1	1	1	1	1	1	1	1	1	1	1	2	3	4	5	6	6	

1	1	1	1	1	1	1	1	1	1	1	1	1	1	1	1	1	1	1	1	1	1	1	1	1	1	1	1	1	1	1	1	1	1	2	4	4	5	6	6	

1	1	1	1	1	1	1	1	1	1	1	1	1	1	1	1	1	1	1	1	1	1	1	1	1	1	1	1	1	1	1	1	1	1	2	4	4	5	6	7	

1	1	1	1	1	1	1	1	1	1	1	1	1	1	1	1	1	1	1	1	1	1	1	1	1	1	1	1	1	1	1	1	1	1	2	3	4	5	6	7	

1	1	1	1	1	1	1	1	1	1	1	1	1	1	1	1	1	1	1	1	2	1	1	1	1	1	1	1	1	1	1	1	1	1	2	3	4	5	6	7	

1	1	1	1	1	1	1	1	1	1	1	1	1	1	1	1	1	1	2	2	2	2	1	1	1	1	1	1	1	1	1	1	1	2	3	4	4	6	7	8	

1	1	1	1	1	1	1	1	1	1	1	1	1	1	1	1	1	2	2	2	2	2	1	1	1	1	1	1	1	1	1	1	1	2	3	4	5	6	7	8	

1	1	1	1	1	1	1	1	1	1	1	1	1	1	1	1	1	2	3	3	3	3	2	2	2	2	2	2	1	1	1	2	2	3	4	5	6	7	8	9	

1	1	1	1	1	1	1	1	1	1	1	1	1	1	1	1	2	3	4	4	4	3	3	3	3	3	3	3	3	3	3	3	3	4	5	6	7	8	9	10	

1	1	1	1	1	1	1	1	1	1	1	1	1	1	1	2	3	4	4	4	4	4	4	4	4	4	4	4	4	4	4	4	5	5	6	7	8	9	10	11	

1	1	1	1	1	1	1	1	1	1	1	1	1	1	1	2	3	4	5	5	5	5	5	5	5	5	6	6	6	5	5	6	6	6	7	7	8	9	11	12	

1	1	1	1	1	1	1	1	1	1	1	1	1	1	1	2	3	4	5	6	6	6	6	6	6	7	7	7	7	7	7	7	7	7	7	8	9	10	11	11	

1	1	1	1	1	1	1	1	1	1	1	1	1	1	1	2	3	4	5	6	6	6	7	7	7	7	8	8	8	8	8	8	8	8	8	8	9	10	11	11	

1	1	1	1	1	1	1	1	1	1	1	1	1	1	1	2	3	4	5	6	6	6	7	7	7	8	8	8	8	8	8	8	8	8	8	8	9	10	10	11	

1	1	1	1	1	1	1	1	1	1	1	1	1	1	1	2	3	4	5	6	6	6	6	7	7	8	8	8	8	8	8	8	8	8	8	8	9	10	10	11	

1	1	1	1	1	1	1	1	1	1	1	1	1	1	2	3	4	4	5	6	6	6	6	7	7	7	8	8	8	9	9	9	8	8	8	8	9	9	10	10	

1	1	1	1	1	1	1	1	1	1	1	1	1	2	3	3	4	5	5	6	6	6	6	6	7	7	8	8	8	9	9	9	8	8	8	8	9	9	9	10	

1	1	1	1	1	1	1	1	1	1	1	2	2	3	3	4	4	5	5	6	6	6	6	6	7	7	7	8	8	8	8	8	8	8	8	8	8	9	9	9	

1	1	1	1	1	1	1	2	2	3	3	3	4	4	4	5	5	5	5	5	5	5	6	6	6	6	7	7	7	7	8	8	7	7	7	7	8	8	8	8	

1	1	1	1	2	2	3	4	4	4	4	5	5	5	5	5	5	5	5	5	5	5	5	6	6	6	6	6	6	6	7	7	6	6	6	6	7	7	7	7	

2	2	2	3	3	4	5	5	6	6	6	6	6	6	6	6	5	5	5	5	5	5	5	5	5	5	5	5	5	6	6	6	6	5	6	6	7	7	7	7	

3	3	3	4	5	5	6	7	7	7	7	7	7	7	6	6	6	5	5	5	5	5	5	5	5	5	5	5	5	5	5	5	5	5	5	6	6	7	7	7	

3	4	4	5	6	6	7	8	8	8	9	8	8	7	7	6	6	5	5	5	5	5	5	5	5	5	5	5	5	5	5	5	5	5	5	6	6	7	7	7	

4	4	4	5	6	7	8	8	9	9	9	9	8	8	7	6	6	5	5	5	5	5	5	5	5	5	5	5	5	5	5	5	5	5	5	6	6	7	7	7	

4	4	4	5	6	7	8	8	9	9	9	9	8	8	7	6	6	5	5	5	5	5	5	5	5	5	5	5	5	5	5	4	4	5	5	6	6	6	7	6	

3	3	4	5	6	6	7	8	9	9	9	9	9	8	7	7	6	5	5	5	5	5	5	5	5	5	5	4	4	4	4	4	3	4	4	5	5	6	6	6	

3	3	4	4	5	6	7	8	9	9	9	9	9	8	7	7	6	6	5	5	5	5	5	5	4	4	4	3	3	3	2	2	2	3	3	4	4	5	5	5	

2	3	3	4	5	6	7	8	9	9	9	9	8	8	7	7	6	5	5	4	4	4	4	4	4	3	3	2	2	1	1	1	1	1	2	3	3	4	4	4	

2	3	3	4	5	6	7	8	9	9	9	9	8	8	7	7	6	5	5	4	4	4	4	4	3	3	2	1	1	1	1	1	1	1	1	2	2	3	3	3	

2	3	3	4	5	6	7	8	9	9	9	9	8	8	7	7	6	5	5	4	4	4	3	3	3	2	1	1	1	1	1	1	1	1	1	1	1	2	2	2	

3	3	3	4	5	6	7	8	9	9	9	9	8	8	7	7	6	5	4	4	3	3	3	3	2	1	1	1	1	1	1	1	1	1	1	1	1	1	1	1	

3	3	4	4	5	7	7	8	9	9	9	9	9	8	8	7	6	5	5	4	3	3	3	2	2	1	1	1	1	1	1	1	1	1	1	1	1	1	1	1	

4	4	4	5	6	7	8	8	9	9	9	9	9	9	8	7	7	6	5	4	3	3	3	2	2	1	1	1	1	1	1	1	1	1	1	1	1	1	1	1	

